  #################################################
        #         #   #     #     # #             #
### # # ### ### ##### ### ### # ### # # # # # ### #
#   # #     #       #     #   # #   # # # # # #   #
######### ### # ##### # # ##### # ########### #####
#       #   # #   # # # #           #             #
# ##### ### # ##### # ### ##### ########### ### ###
#   # #     #   #     #     #       # #   # #     #
##### # # ### # # ### ########### ### ### # #######
# #   # # #   # #   # #           # #       # # # #
# ### ####### ##### ### # ####### # ##### # # # # #
#   #       # #     #   # #         # #   # #     #
# ##### ### # ############### ####### ### # # # # #
#     #   # # #   # # #     #       # # # # # # # #
# ### # # ### # # # # ### # # ##### # # # # ### ###
#   # # # #   # # #     # #   #   #     # # #   # #
# ### ### # ##### # ####### # ### ### ### ### ### #
#   # #   #           #   # # # # #     # #       #
# ##### # ##### ##### # ### ### # ####### ####### #
#   #   #   #   # #   #   # #               # # # #
### ##### # ### # # # ### # ##### # # ##### # # # #
#         #       # #       #     # # # #       # #
# ### ### # ### ##### # ##### ##### ### # ####### #
#   #   # # # # # #   #   #   #       #       #   #
##### ### ### ### ##### # ### ### ##### ##### ### #
# #     # #       #     #     #     # # #   # # # #
# # # # ### # # ##### # # # ##### ### # ### # # # #
# # # # # # # #   # # # # # #   # # #   #     # # #
# # ### # # # ##### # # ####### ### ####### # # # #
# # # #     # #       #     #   #           # #   #
# # # ##### # ######### # # ### ### # ### ##### ###
#       # # #     # # # # # # # # # # # #   # #   #
### ##### # ### # # # ##### # # # # # # # # # ### #
#   # #   # #   # #     #       #   # #   #       #
# # # # # # ##### # ##### # ### ### ### ######### #
# #     # #   # # # #     # #   # #   #     # #   #
# ####### # ### # # ##### ####### ######### # ### #
#       # #     # #     # #   #   #           #   #
################# ##### ### ### ### ##### ####### #
#         #         #         #       #   #       #
### # ############### ##### ### ### ##### ####### #
#   # #   #     #     # # # # # #   #         #   #
# # # # ##### ##### ### # ### ##### # ### ##### ###
# # # # #     #   #   #   # # # # # #   #   #     #
# # ### # # # # # # ### # # # # # # # ##### # #####
# # # #   # #   # #     # #       # # #   # # #   #
### # # # ####### ### ##### # ### # # # ####### # #
# #     # #                 # #     #       # # # #
# # # ####### ######### # # ##### ### ### ### # ###
#   #       #         # # # #       # #           #
#################################################