  #################################################
    #   #     #     #     #       #     #   #     #
### ### # # ##### ##### # ### ### # ### ### ##### #
# #       #     #   #   # #     #   #     # #     #
# # # # # ### ### # # # ########### # ##### ### # #
#   # # # # #   # # # # #     #   # #           # #
### ### ### ##### ### # # ####### ### # ######### #
#   # #     # #       #     # #     # #     #     #
### # ####### # # # # ####### ### # # ##### # ### #
#   # # # #     # # # # # #       #   #   # # # # #
### # # # # # ### ##### # # # ### # # # ##### # # #
# #   # #   #   #   #       # # # # #     #   #   #
# # ### # ####### ### ####### # # # ##### ####### #
#           #           #   #   # # #       #   # #
### ### # ##### ######### ##### ### ##### # # #####
# # #   #     #   #       #     #     # # # # #   #
# # # ######### # # ### # ##### ##### # ### # ### #
#   # #     #   # #   # # # #   #   # # #     # # #
### # ##### # ##### # ### # ### ### # # ####### # #
#   # #     # # #   #   # #         # #   # #     #
# ##### # ##### # ### ######### ### # ### # ##### #
# #   # # #     # #   #         # # #   #     #   #
# # ##### # ####### ############# # ### # ##### ###
#   # #   #     #     # # #   #     #     # # #   #
# ### # ##### ### # ### # # ### ######### # # ### #
# # #     # # # # # # #     #       #       # #   #
# # # ##### # # # # # ### ##### # # # ### ### # # #
# #   #     #   # #   #     #   # # # #   #     # #
# # ### ##### # # ### # # ##### ##### ### # ##### #
#     #     # #   # #   # #     #   # # #   #   # #
# ### # # # # ### # ##### ### ### ### # # # # ### #
#   #   # #   #     # #   #       # # #   #     # #
# ######### # # # ### ########### # # ######### # #
# # #       # # #     # #     #     #     #     # #
# # ### ##### # ####### # ##### # # # ##### ##### #
#   #   # # # #       #   # #   # # # # # # #     #
### ##### # ### ####### # # # ### # ### # ##### # #
# #     #   #   #     # #   # # # # #       # # # #
# ######### # ### ##### # # # # ### ### ##### ### #
# #         # # # #     # # #     #   # #   # # # #
# # # # ##### # # # ### ########### ### # ### # # #
#   # # #   #         # #       # # #       # #   #
### ##### ##### ##### ####### ### ### # ##### #####
# #   #   #         #         #   #   #   #   #   #
# ### # ####### ######### ### # # # # ####### ### #
#   #     #     #     #   #     # # #   #         #
### # ############# # # ### # # # # ### ##### ### #
#   # # # #       # #   #   # # #   #           # #
# ### # # # # ### # ### ####### ### ####### # #####
#           # #     #       #     #     #   #
#################################################