  ###################################################################################################
          # # #           #     #         #     # #   # # #           #     #                       #
# ##### ### # ####### # # # ############# # # # # # # # # # ####### ### ############# ### ######### #
# # #         # # #   # # #     #         # # #   # # #     #   #   #         #   # # # #       #   #
### # # # ### # # ### ####### ### ######### # ####### ### ##### # ######### ### ### ### ### # #######
#     # # #       #   #   # #           # # #     #       #     #   # #   #           #     #   #   #
# ### ### ### # ### ##### # ##### ### ### # ########### # ### # ##### # ##### ####### ### ##### # ###
# #   # # #   #   #       #       # #       # # # #   # #   # #               # #           #       #
##### # # ####### # # ##### ### # # # ##### # # # # ####### # # ### ##### # ### ######### ### # ### #
#   # # #     # # # #   # # # # #   #   # #           #   # # #   # #     # # # # # # # # #   # #   #
### # # # ### # # ##### # ### # # ##### # ### ##### # # # # ############# # # # # # # # # # ####### #
#     #   #   #         #   #   # #       #     # # # # # #   #   #   #   # # #   #       #   # #   #
# ##### ### ########### # # ########### ####### # # # # # ### # # # ### ### # ### ### ### ### # #####
# #   # # #           # # # #     #   #       # #   #   #   # # # # # # #     #   # # # #   # # # # #
# # # # # ### ### ######### ### ##### # ### # ####### ##### # ### # # ### # # # ### # # ### ### # # #
#   # #   #   # #       #   #   #         # # #   #   #   #           #   # # #         # #   #     #
# # # # ### ### ### ### # # # # # # # ####### # # ##### # ### ### ### ####### # # ### ### # ####### #
# # # # # #     #     # # #   # # # # #       # # # #   #     #   #       #   # # # #   #     #   # #
######### ##### ### # ### ### ##### ##### ### # # # ################### ######### # ##### ### ### # #
#     #   #   # #   #       # # #   #     # # # #                   #     #   #     # #   # #       #
# ### # ### ##### ### ### # ### # ### # ### ### ### ####### ##### ##### # ### ### ### # ### ##### # #
# #     # #     # #   #   #   #   # # #     # # #       # #   #     #   #           #   #       # # #
##### # # ##### # # ### ##### # ### ##### ### ######### # ### ### ### ##### ##### ### # ### ####### #
#     # #     #   # # #   #     #   #           #       #       #   #   # #   #   #   # #     #     #
### ####### ### ##### ############# ####### ########### ##### # ####### # ### # ####### ### ##### ###
#   #   #     # # # #   # #   #     # #   # # #   #       #   #     # # #   # #   #             #   #
# ##### # ### # # # ### # ### # # ### # # ### # # ##### ### # ####### ##### # ### ################# #
#     #   #   #         #     # # # #   #     # # # #   #   #   #     #       #         #   #       #
##### ### # # # # ##### # # ### ### ### ##### ### # ####### # # ##### ##### ##### ### ### ### # # ###
#         # #   #   #     #     #   # # #     #     #   #   # #     #   # # # #     # #   #   # #   #
### # ########### ########### ##### # ### ### # # ### ### ####### # # ### # # # ### ### ########### #
#   # #         # #   #   #                 #   #         #     # # #   #   #     # # # #   #     # #
### ### # ### ### # ##### ############# # ##### # ############# ##### # ########### # # # ##### # ###
#   #   #   # #     #         #     #   # #     #     #         #     # #   #   # # #       # # # # #
### ##### ### ### # # ######### ################### ### # ### ### ### # # ##### # ####### ### # ### #
# # #       #     #       # #             #             # #   #   # # # #           #     #     #   #
# ### ####### ##### ### # # ##### ### ### ##### ##### # ######### # ############### # ##### ### # ###
# #   # #   #   #     # # #         #   # #   # #     # #                 #   #     #       # #     #
# ##### ### ########### ############### # ### # ### # # # ####### # # ### ### ##### # ### # # # #####
#     #     #               # #   #     #       #   # # #     # # # #   # # # #         # #   # # # #
# # # # # # # ### ######### # ### ### # ### ####### # ##### # # # ### # # # # # ######### # ##### # #
# # #   # # #   #     #       # # #   #   # # #   # # #     # # # #   # # #   # #   # #   #         #
##### ########### ######### ### # ### ### ### ### ############# # ##### # # ### # # # ### # # ##### #
# #   # #   #   #       # # # #     #   #   #       #   # #       #     # #       # #   # # # #     #
# # # # ### # ### ##### # ### ### ######### ##### ### # # # # ########### # ####### ### ######### # #
#   # #         # # # #       #       #   #     #     # #   #   #             #     #   #     # # # #
# # ####### ####### # ### ##### # ##### # # # # ### ### # ####### # # # # ### ####### # ##### # ### #
# #   #             # #   #   # #     # # # # # #   # # #     #   # # # #   # #       #   #   # # # #
# # # # # ### ### ### ####### ####### # ### ### # ### # ### ################# # # # # # # ### # # ###
# # # # #   # #           #   # #     #       #   #   #     # #       #     #   # # # # # #   # # # #
##### ### # # ### # ### # # ### ### ### ######### # # ### # # ####### # ### # # # ### ##### ### # # #
#   # #   # #   # #   # #   #     #   # #   #       # #   #     #         #   # # #     #   # #     #
# ### # ####### ### # ### # ### ##### ### ### ####### ##### # ##### # # # # ### ##### ### # # ### ###
#         # # # #   # #   #       #   # #   # #         #   #     # # # # # #     #       #         #
# ### # ### # # # # ##### ####### ### # # ### ### ##### ################# ##### ####### # ##### # # #
# #   # # # #   # #     # #   #       #   # # # # #           # #     #   # # # #     # #   #   # # #
# # ### # # # # ####### ##### # ##### # # # ### # ####### ### # ##### ##### # # ##### # ########### #
# # #       # # # #     # # #   #       #     #   # #       # #   #     # # #       #   #     #     #
# ### ##### # ### # ### # # # # ########### # ### # # ### ### # ##### ### # ### # ####### # ##### ###
# #   #   # # #   #   # # #   #       # #   # # #   # #   #     #     #         # #       #     #   #
### ### # # ##### # ##### # ####### ### ##### # ### ##### # # ### ########### ### ######### ####### #
#     # #   # #   # #     # #     #     # #   #   #     # # # #   #   #   #     # #       #         #
########### # # # # # ####### ### # ##### # ##### # ### ######### # # # # # ### ##### ### # ##### # #
#   #   #   # # #   # # #       # #     #           # #   #   #     #   #   #     # # #   #   # # # #
### # # ##### ### ### # # ################# ##### # # ### ### # # ##### ######### # # ##### ### # # #
#     #     #   #         # #   # #           # # #   #   #     #   #     # #   #       # # # #   # #
# # # # # # ### # ##### ### # ### ### # ##### # ##### ##### ######### # ### # ####### ### ### # #####
# # # # # #       #   #   #   #       # #     #   # #   #   #       # #       #   #   #     #   #   #
##### ############# # ### # # # # ######### # # ### ### ##### ### # ### # ##### ######### # # # # # #
# #   #             # #   # #   #   #   # # #     #   # #   #   # # # # # #   #   #   # # # # # # # #
# # # # # ################# ### ### # ### # ##### # ##### ####### # # ### # ##### # ### # # # ### ###
#   # # #     #     #     # # # # #       #   #     # # # #   # # # #     # #   #     #   #   #     #
# ########### # ### ##### # # ### ### # ##### ### ### # # ### # ### ### ### # # ### # ### # ####### #
#   #       #     # # # #   #   # #   # #       # # #     #   #         # #   #     # #   # #     # #
##### # ### # ####### # ### # ### # ####### # ### # # ##### ############# ### ############# ##### # #
#     # #     # # # #         #   #   #     # # # #   #       #         # #     #     # #     #   # #
# ### ##### ### # # # ####### ### ### ##### # # ##### # # ####### # # ### # # ### ### # # ##### ### #
#   # #   #     #         # # #   #   # #   #   #   # # # #     # # #     # #   # #   #             #
### ### ### ### # # ####### # ### ### # ####### # ### # ### ### # # ### ### # ##### ##### ##### # ###
#   #   # #   #   #     # #     #   #     #           #       # # # #     # # #   # #   #   # # # # #
# # # ### # # ### # ##### # # # # ##### # ##### ##### ### ######### ##### ### # ### # ### ### # # # #
# #   # #   # # # #     #   # # #   # # # #   #   #   # #     #       #   #     #   #       #   # # #
# ### # # # ### ######### ### ### ### # ### # ### ### # # ### ##### # ##### ### ### ##### ### ##### #
#   # #   #   #       # # # # # #   #       # # # #   #   # #       #         #   #     # #         #
# ### ##### ##### ##### ### # # # ### ### ##### ##### ##### # ##### # ### ##### # # ########### #####
# #       #     #         #   #   # #   #   #     #   #       #     #   #   # # #       # #     #   #
# # ### ### ##### # # # ##### ### # # ##### # # # ### # # ### ######### # ### ##### # # # # ####### #
# # #   # # # #   # # # #   #   # #       # # # # #   # #   #     # #   # # #   #   # #     # # #   #
### # ### ### ### ### # ### # ### # ########### ### # ### ######### # # ### # ##### ####### # # ### #
#   #   #       # #   #         # #   #   #       # # # # #   #     # # # #     #   #         # #   #
# ##### ### ### # ########### ### # # # ### ### ### ### # # # ### # # ### ### ##### ##### ##### # # #
# #   #     #   #   # # #   # # #   # #     #   #   # # # # #     #   #     #   #   #     #   #   # #
### # ##### ##### ### # ### ### # ### # ### # # # ### # ####### # ### # ####### ##### # # ### ### ###
#   #           # #   #     #   # #     # # # # #   #           # #           # # # # # # # #     # #
##### # ##### ### # # ### # # ### # ### # ### ####### # # # ##### ######### ### # # # # # # ##### # #
# #   # #     #     # # # # #   # #   # #     #   # # # # # # # # #         # #   #   # #           #
# ### ########### ### # # ##### # ##### # # ### ### ### ### # # ### # # ### # # ### ####### # ### # #
# #   # # #     #   #     # # #     #   # #   # #   #   # # # # #   # # #         #   # #   # # # # #
# # # # # ##### # ### ##### # # ####### # ### # # ### # # ### # # ### # ### # ####### # ##### # # # #
#   #     #       #           #     #   #   #   #     #   #       #   # #   # #         #     #   # 
################################################################################################### 

